NO ./textures/brick.xpm
SO ./textures/cobblestone_mossy.xpm
WE ./textures/planks_big_oak.xpm
EA ./textures/stone_bricks.xpm
S ./textures/sprites.xpm

F 000,000,255
C 000,255,000

11111111111111
10100000100001
10100000100001
10000N00000001
10000010000001
10000000000001
10000000000001
10000000000001
11111111111111
