NO ./textures/brick.xpm
SO ./textures/cobblestone_mossy.xpm
WE ./textures/planks_big_oak.xpm
EA ./textures/stone_bricks.xpm
S ./textures/sprites.xpm

F 220,100,0
C 225,30,0

1111111111111111111111
1000000000000000000001
1000000000000000000001
1000000000000000000001
1000000000000000000001
1000000000000000000001
1000000000000000000001
1000000000000000000001
1000011010010000000001
1000000000000000000001
1000000000000000000001
1000000000000000000001
1000000000000000000001
1000000000000000000001
10000000000N0000000001
1000000000000000000001
1000000000000000000001
1000000000000000000001
1000000000000000000001
1000000000000000000001
1000000000000000000001
1000000000000000000001
1111111111111111111111
