SO ./textures/brick.xpm
NO ./textures/cobblestone_mossy.xpm
WE ./textures/planks_big_oak.xpm
EA ./textures/stone_bricks.xpm
S ./textures/sprites.xpm

F 000,000,255
C 000,255,000

11111111111111111111111111
10000000000000000000000001
10000000000000000000000001
10000000000000000000000001
10000000000000000000000001
10001000000000111000000001
10000000000000000000000001
10000000000000000000000001
10000000000000000000000001
10000000011000000000000001
10001000011000000000000001
10001000000000000000000001
10000000000000N00000000001
10000000000000000000000001
10000000000000000000000001
10000000000000000000000001
10000000000000000000000001
10000000000000000000000001
10000000001000000000000001
10000000001000000000000001
10000000001000000000000001
10111111111000000000000001
10000000000000000000000001
11111111111111111111111111
